1,1,1,1,1,1,1,1,1,1
1,1,T,0,0,0,D,0,X,1
1,1,0,1,D,0,1,0,0,1
P,1,0,1,1,0,1,D,1,1
0,0,0,0,0,0,0,0,1,1
1,1,K,1,1,0,1,0,1,1
1,1,0,0,0,0,0,K,0,1
1,1,1,1,1,1,1,1,1,1